R 1920 1080

NO ./path_to_the_north_texture.xpm
SO ./path_to_the_south_texture.xpm
WE ./path_to_the_west_texture.XPM
EA ./path_to_the_east_texture.xpm
S  ./path_to_sprite_guard.xpm

F 220,100,0



111111111111111111111111111
100000000011000000000000111
11011000001110000000000001
100102000N000000000000001
111111111011000011100001
100000000011000001110111111111111
11110111111111011100000010001
11111111111111011101010010001
11000000110101011100020010001
1000000200000111000000100011
1000200000000001101010010001
1100000111010101111101111000111
11110111 1110101 101111010001
11111111 1111111 111111111101