R 1920 1080

NO ./path_to_the_north_texture.xpm

SO ./path_to_the_south_texture.xpm

WE ./path_to_the_west_texture.xpm


EA ./path_to_the_east_texture.xpm

S  ./path_to_sprite_guard.xpm

F 220,100,0

C 255,255,55
    
        
           
        1111
       11111111111111111111111111
111111110000000000000001
        1111111111111111
1111111111111121111111111111111
1111111111111111111111111111
1000000200000111000011100011
1000200000000001101010010001
1100000111010101111101111000111
11110111 1110101 101111010001
11111111 1111111 1111111 111111111111111