R 1920 1080

NO ./path_to_the_north_texture.xpm

SO ./path_to_the_south_texture.xpm

WE ./path_to_the_west_texture.xpm

EA ./path_to_the_east_texture.xpm

S  ./path_to_sprite_guard.xpm

F 220,100,0

C 0,0,0

1111111111111
100000000N001
1111111111111