R 1920 1080
NO ./path_to_the_north_texture.xpm
SO ./path_to_the_south_texture.xpm
WE ./path_to_the_west_texture.xpm
EA ./path_to_the_east_texture.xpm
S  ./path_to_sprite_guard.xpm
F  220,225,255
C  0,0,0

 1111111111111111111111111111111111111
1001001000000000000000000000000000001
 1111100111110000111111111111100000001
    1000111000000111111111111100000001
    10001110000001            100000001
    10001110000001            10000000111111111111111111
    10001110000001      1     100000000000000000000000001
    10001110000001     121   10100000000000000000000000001
    10001110000001      1     100000001111111111111111111
    10001110000001            100000001
    10001110000001            10000000111111111111111
    1000000000001111111111111100000000000000000000001
    1000000000000000000000000000000000000000000000001
1111000000N000000000000200000020000002000020000002001
111100000000000000200000000002000000020000200000020001                  
11111111111111111111111111111111111111111111111111111          11111111111111        
                                                               100000021    1       
                                                               100000001    1     
                                                               11111111111111   
 1111111111
   100000001
    100000001
    1111111111