
R 1920 1080
NO ./path_to_the_north_texture
SO ./path_to_the_south_texture
WE ./path_to_the_west_texture
EA ./path_to_the_east_texture




F 220,100,0
C 225,30,0

111111111111111111111111111111
100000000000000000000000000001
100010000100000000000000000001
100000001000000000000000000001
100000100000000000000001000001
100000000001000000000001000001
100000000000000000000001000001
1000000000000N0000000001000001
100000000000000000000001000001
100000010000000001000001000001
100010000000000000000001000001
100000000000000000000001000001
100000001000001000000000000001
100000000000000000000000000001
100000000000000000000000000001
111111111111111111111111111111